%%%%%%%%%%
% P     G%
%%%%%%%%%%