%%%%%%%%%%%%%
%     P     %
%% % % % % %%
%           %
% % % % % % %
%           %
%% % % % % %%
%GGGGGGGGGGG%
% % % % % % %
%           %
%% % % % % %%
%           %
%%%%%%%%%%%%%