%%%%%%%%%%%%%%%%%%%%
%PGGGGGGGGGGGGGGGGG%
%GGGGGGGGGGGGGGGGGG%
%GGGGGGGGGGGGGGGGGG%
%GGGGGGGGGGGGGGGGGG%
%GGGGGGGGGGGGGGGGGG%
%GGGGGGGGGGGGGGGGGG%
%GGGGGGGGGGGGGGGGGG%
%GGGGGGGGGGGGGGGGGG%
%GGGGGGGGGGGGGGGGGG%
%GGGGGGGGGGGGGGGGGG%
%GGGGGGGGGGGGGGGGGG%
%GGGGGGGGGGGGGGGGGG%
%GGGGGGGGGGGGGGGGGG%
%GGGGGGGGGGGGGGGGGG%
%GGGGGGGGGGGGGGGGGG%
%GGGGGGGGGGGGGGGGGG%
%GGGGGGGGGGGGGGGGGG%
%GGGGGGGGGGGGGGGGGG%
%%%%%%%%%%%%%%%%%%%%