%%%%%%%%%%%%%%%%%
%               %
% P . . . . G   %
%               %
%%%%%%%%%%%%%%%%%
