%%%%%%%%%%%%%%%%%
%      %%%%     %
% P .     .     %
%    % G %%%%   %
%      .        %
%%%%%%%%%%%%%%%%%
