%%%%%%%%%%%%%%%%%
%P G      .     %
%           .   %
%   .      %%%  %
%        .  .   %
%%%%%%%%%%%%%%%%%
