%%%%%%%%%%%%%%%%%
% P .      .    %
%    %%% G .    %
%    .    %%%   %
%   .         . %
%%%%%%%%%%%%%%%%%
