%%%%%%%%%%%%%%%%%
%        .      %
%    %%%        %
% P   G .  .    %
%    %%%        %
%         .     %
%%%%%%%%%%%%%%%%%
