%%%%%%%%%%%%%%%%%%%%
%.o         o..%   %
%.%%.%%.%%.%%.%% %.%
%        P       %.%
%%%%%%%%%%%%%%%%%%.%
%..................%
%%%%%%%%%%%%%%%%%%%%
