%%%%%%%%%%%%%%%%%%
%.%%%%%%%%%%%%%%.%
%P%..............%
%.%.%%%%%%%%%%%%.%
%...          .%.%
%.%%%%%%%%%%%%%%.%
%%%%%%%%%%%%%%%%%%